Git Push. 
Money Out - ServeTransfer to Bank  Show Help  Bank AccountExternal Bank Account -*5652  70,730.00Command:
git cherry-pick <commit-hash>  $  Oops! Looks like you don't have enough money in your Account, lower the amount or add money.  Review  Transfer to Bank  Show Help  Bank AccountExternal Bank Account -*5652  70,730.00  $  Oops! Looks like you don't have enough money in your Account, lower the amount or add money.  Review   	Money Out - Serve
Skip to Main Content	Skip to Main Content
Home	Home
Money In	Money In
Money Out	Money Out
FAQs	FAQs
Logout	Logout
My Profile	My Profile
Money Out	Money Out
Cash Pickup Powered by RiaYou can pick up cash at Walmart locations	Cash Pickup Powered by RiaYou can pick up cash at Walmart locations
ATM FinderFind ATM locations near you	ATM FinderFind ATM locations near you
Bill PaySet up, pay and manage bills	Bill PaySet up, pay and manage bills
Walmart Money Transfer Powered by RiaFriends and family can pickup cash at Walmart locations	Walmart Money Transfer Powered by RiaFriends and family can pickup cash at Walmart locations
Send MoneyMove money to another Serve Cardholder	Send MoneyMove money to another Serve Cardholder
Transfer Out of Main AccountTransfer money to a Subaccount or Goal	Transfer Out of Main AccountTransfer money to a Subaccount or Goal
Transfer to BankMove money from your Serve Account to a linked bank account	Transfer to BankMove money from your Serve Account to a linked bank account
Product	Product
Jackson Hewitt	Jackson Hewitt
Resources	Resources
Fee ChartATM FinderLegal/Privacy	Fee ChartATM FinderLegal/Privacy
Support	Support
FAQsContact Us	FAQsContact Us
	
Serve® American Express® Jackson Hewitt® Prepaid Debit Account and card are issued by American Express Travel Related Services Company, Inc., 200 Vesey Street, New York, NY 10285. American Express Travel Related Services Company, Inc. is licensed as a money transmitter by the New York State Department of Financial Services. NMLS ID# 913828. Click here for information about addressing complaints regarding American Express's money services business, lists of American Express's money services business licenses, and other disclosures.	Serve® American Express® Jackson Hewitt® Prepaid Debit Account and card are issued by American Express Travel Related Services Company, Inc., 200 Vesey Street, New York, NY 10285. American Express Travel Related Services Company, Inc. is licensed as a money transmitter by the New York State Department of Financial Services. NMLS ID# 913828. Click here for information about addressing complaints regarding American Express's money services business, lists of American Express's money services business licenses, and other disclosures.
	
Click here for information regarding FDIC pass-through insurance on the Serve Prepaid Debit Accounts.	Click here for information regarding FDIC pass-through insurance on the Serve Prepaid Debit Accounts.
	
Users of the Serve Prepaid Debit Accounts are subject to American Express's Privacy Statement.	Users of the Serve Prepaid Debit Accounts are subject to American Express's Privacy Statement.
	
Apple and the Apple logo are trademarks of Apple Inc., registered in the U.S. and other countries. App Store is a service mark of Apple Inc.	Apple and the Apple logo are trademarks of Apple Inc., registered in the U.S. and other countries. App Store is a service mark of Apple Inc.
	
Android and Google Play are trademarks of Google Inc.	Android and Google Play are trademarks of Google Inc.
	
All users of our online services agree to be bound by the Terms of Use.	All users of our online services agree to be bound by the Terms of Use.
	
Copyright ©2024 InComm Payments™. All Rights Reserved. All trademarks are the property of their respective owners.	Copyright ©2024 InComm Payments™. All Rights Reserved. All trademarks are the property of their respective owners.
Transfer to Bank	Transfer to Bank
Show Help	Show Help
Bank AccountExternal Bank Account -*5652	Bank AccountExternal Bank Account -*5652
70730	70,730.00
$70730	$70370.00
Processing Complete
Review	complete
The completion of this transaction is subject to the terms of the Consumer User Agreement.	The completion of this transaction is subject to the terms of the Consumer User Agreement.
